1111111111
1P00001C11
1000111001
1000E00001
1000000001
1111111111